360手机助手,工具,100084,272256995,272063778,193217,276024.2857,2018/1/7
人民日报,阅读,101273,68160515,68145349,15166,21665.71429,2018/1/7
风行视频,视频,101594,92485869,92450347,35522,50745.71429,2018/1/7
作业帮,教育学习,1027306,73288688,71882793,1405895,2008421.429,2018/1/7
高德地图,出行,1038,460616069,457455457,3160612,4515160,2018/1/7
手电筒,工具,1066354,104743565,104728940,14625,20892.85714,2018/1/7
美团,便捷生活,1068,314257445,312871143,1386302,1980431.429,2018/1/7
QQ浏览器,系统,1079,438439689,436639418,1800271,2571815.714,2018/1/7
阿里星球,视频,1088,330096415,330087846,8569,12241.42857,2018/1/7
铃声多多,视频,111237,205747969,205136245,611724,873891.4286,2018/1/7
掌阅iReader,阅读,1152,172710533,172464000,246533,352190,2018/1/7
讯飞输入法,社交,1167,339955080,338734791,1220289,1743270,2018/1/7
百度视频,视频,12272,164767125,164684080,83045,118635.7143,2018/1/7
Flipboard,阅读,123565,113117247,112950069,167178,238825.7143,2018/1/7
唱吧,视频,125088,110037732,109945626,92106,131580,2018/1/7
今日头条,视频,141843,333100197,329582831,3517366,5024808.571,2018/1/7
墨迹天气,工具,1433,421840953,420748138,1092815,1561164.286,2018/1/7
鲁大师,系统,147287,94575817,93967270,608547,869352.8571,2018/1/7
三星打印服务插件,系统,1557729,114341096,114158147,182949,261355.7143,2018/1/7
360省电王,系统,1569,197118122,197052515,65607,93724.28571,2018/1/7
搜狐视频,视频,1586,233092796,232681089,411707,588152.8571,2018/1/7
手机京东,育儿母婴,1588,164890919,163612463,1278456,1826365.714,2018/1/7
开心消消乐,游戏,1625930,415150964,413671905,1479059,2112941.429,2018/1/7
酷我音乐,视频,1656,405842956,404525818,1317138,1881625.714,2018/1/7
360清理大师,系统,1781604,185751913,183616336,2135577,3050824.286,2018/1/7
搜狐新闻,阅读,1849,97069994,96849916,220078,314397.1429,2018/1/7
滴滴出行,出行,185732,149671371,148728595,942776,1346822.857,2018/1/7
平安普惠,理财,1937214,17379002,16355311,1023691,1462415.714,2018/1/7
支付宝,理财,1939,678675259,675025586,3649673,5213818.571,2018/1/7
腾讯新闻,阅读,19467,314794531,313582090,1212441,1732058.571,2018/1/7
360免费WiFi,系统,1954941,246651750,245318569,1333181,1904544.286,2018/1/7
美图秀秀,摄影,1977,408414359,407549276,865083,1235832.857,2018/1/7
微博,阅读,2012,689583368,687642513,1940855,2772650,2018/1/7
咪咕音乐,视频,201224,81296155,80634412,661743,945347.1429,2018/1/7
UC浏览器,系统,2058,682860588,681159084,1701504,2430720,2018/1/7
腾讯视频,视频,2087,435556620,432683988,2872632,4103760,2018/1/7
QQ邮箱,办公商务,209310,131297981,130743707,554274,791820,2018/1/7
唯品会,购物,21972,100779584,100097081,682503,975004.2857,2018/1/7
中华万年历日历,工具,2272,144522988,144175684,347304,496148.5714,2018/1/7
美颜相机,摄影,229226,174452309,173766289,686020,980028.5714,2018/1/7
360超级ROOT-深度优化手机,工具,2304476,156784385,156270336,514049,734355.7143,2018/1/7
喜马拉雅FM,视频,236026,88417828,88141380,276448,394925.7143,2018/1/7
驾考宝典,教育学习,2378,113416929,112963163,453766,648237.1429,2018/1/7
随手电筒,工具,246564,96123471,96086376,37095,52992.85714,2018/1/7
单机斗地主-不占流量,游戏,263710,198528853,198006379,522474,746391.4286,2018/1/7
网易新闻,阅读,2744,89436905,89017730,419175,598821.4286,2018/1/7
相机360,摄影,2747,104394374,104335403,58971,84244.28571,2018/1/7
爱奇艺,视频,2751,564941175,561980450,2960725,4229607.143,2018/1/7
书旗小说,阅读,2926,132383225,132098132,285093,407275.7143,2018/1/7
网易有道词典,教育学习,2927,191343069,191095570,247499,353570,2018/1/7
携程旅行,出行,2947,134048173,133482500,565673,808104.2857,2018/1/7
花椒直播-美颜椒友疯狂卖萌,社交,2981222,118161573,116805735,1355838,1936911.429,2018/1/7
王者荣耀,游戏,3073428,168909031,163608728,5300303,7571861.429,2018/1/7
快手,视频,3536,145083074,141996794,3086280,4408971.429,2018/1/7
手机淘宝,育儿母婴,3570,877830194,874390266,3439928,4914182.857,2018/1/7
ES文件浏览器,系统,3571,90610710,90544395,66315,94735.71429,2018/1/7
优酷,视频,3581,777903432,775617966,2285466,3264951.429,2018/1/7
蔚蓝小说,阅读,3885739,35105505,30676832,4428673,6326675.714,2018/1/7
小说,阅读,3894208,21929908,16915383,5014525,7163607.143,2018/1/7
免费小说,阅读,3937914,7081953,1962242,5119711,7313872.857,2018/1/7
YY,视频,4067,113960034,113232288,727746,1039637.143,2018/1/7
土豆视频,视频,4107,113246980,113090791,156189,223127.1429,2018/1/7
途牛旅游,出行,43299,144814458,144586721,227737,325338.5714,2018/1/7
酷狗音乐,视频,433,1128850193,1125062186,3788007,5411438.571,2018/1/7
多米音乐,视频,44,97112902,96980590,132312,189017.1429,2018/1/7
QQ音乐,视频,4498,137120239,135531538,1588701,2269572.857,2018/1/7
大众点评,生活服务,4674,170856230,170511094,345136,493051.4286,2018/1/7
陌陌,社交,48,242075547,241475449,600098,857282.8571,2018/1/7
蜻蜓FM,视频,51178,82182888,81945082,237806,339722.8571,2018/1/7
我查查,工具,537,160543812,160509406,34406,49151.42857,2018/1/7
微信,社交,5427,754534183,747190189,7343994,10491420,2018/1/7
58同城,便捷生活,5576,85901586,85470272,431314,616162.8571,2018/1/7
聚力视频,视频,5632,273673558,273273812,399746,571065.7143,2018/1/7
天气通,工具,6209,93783255,93720801,62454,89220,2018/1/7
谷歌拼音,系统,6224,126386249,126303980,82269,117527.1429,2018/1/7
乐视视频,视频,6276,256917264,256597524,319740,456771.4286,2018/1/7
谷歌Gmail,办公商务,6411,92766450,92657825,108625,155178.5714,2018/1/7
驾校一点通,教育学习,6533,36873748,36811856,61892,88417.14286,2018/1/7
咪咕阅读,阅读,6536,119743610,117091714,2651896,3788422.857,2018/1/7
飞信,社交,7372,94941106,94917489,23617,33738.57143,2018/1/7
百度地图,出行,7655,572204699,570783778,1420921,2029887.143,2018/1/7
植物大战僵尸2高清版,游戏,771431,214940217,214117457,822760,1175371.429,2018/1/7
360手机卫士-一键连免费wifi,系统,77208,1892042402,1884180433,7861969,11231384.29,2018/1/7
360影视大全,视频,778702,417007981,415332477,1675504,2393577.143,2018/1/7
QQ,社交,7953,787007075,784969309,2037766,2911094.286,2018/1/7
华为手机文件管理器,办公商务,796062,101822731,100920278,902453,1289218.571,2018/1/7
QQ空间,社交,8015,133079670,132855944,223726,319608.5714,2018/1/7
ogle 文字转语音,系统,885077,118608874,118550192,58682,83831.42857,2018/1/7
WiFi万能钥匙,系统,88761,982822998,977458435,5364563,7663661.429,2018/1/7
HP Print Service 插件,系统,890932,112572496,112467432,105064,150091.4286,2018/1/7
360天气,工具,92235,118565839,118495264,70575,100821.4286,2018/1/7
中国建设银行,理财,9347,105006312,103984293,1022019,1460027.143,2018/1/7
去哪儿旅行,出行,944,120993638,120531684,461954,659934.2857,2018/1/7
360浏览器,系统,95487,657810841,653766424,4044417,5777738.571,2018/1/7
铃声多多,视频,111237,206335167,205969814,365353,782899.2857,2018/2/4
唱吧,视频,125088,110184220,110083914,100306,214941.4286,2018/2/4
酷我音乐,视频,1656,407000693,406219567,781126,1673841.429,2018/2/4
咪咕音乐,视频,201224,85293746,82637847,2655899,5691212.143,2018/2/4
酷狗音乐,视频,433,1132170386,1129568500,2601886,5575470,2018/2/4
多米音乐,视频,44,97183765,97136876,46889,100476.4286,2018/2/4
QQ音乐,视频,4498,139219409,137631894,1587515,3401817.857,2018/2/4
蜻蜓FM,视频,51178,82375768,82261919,113849,243962.1429,2018/2/4
360手机助手,工具,100084,272937229,272795297,141932,202760,2018/4/8
人民日报,阅读,101273,86544000,86533614,10386,14837.14286,2018/4/8
风行视频,视频,101594,92609619,92582822,26797,38281.42857,2018/4/8
作业帮,教育学习,1027306,79517168,78270758,1246410,1780585.714,2018/4/8
高德地图,出行,1038,469772575,468097701,1674874,2392677.143,2018/4/8
手电筒,工具,1066354,104802501,104794026,8475,12107.14286,2018/4/8
美团,便捷生活,1068,318070870,317330496,740374,1057677.143,2018/4/8
QQ浏览器,系统,1079,444853661,443613616,1240045,1771492.857,2018/4/8
阿里星球,视频,1088,330124646,330120347,4299,6141.428571,2018/4/8
铃声多多,视频,111237,208050052,207623380,426672,609531.4286,2018/4/8
掌阅iReader,阅读,1152,173483618,173326882,156736,223908.5714,2018/4/8
讯飞输入法,社交,1167,344798868,343932586,866282,1237545.714,2018/4/8
百度视频,视频,12272,165139837,165076072,63765,91092.85714,2018/4/8
Flipboard,阅读,123565,113753650,113628868,124782,178260,2018/4/8
唱吧,视频,125088,110474610,110393857,80753,115361.4286,2018/4/8
今日头条,视频,141843,342657135,,,,2018/4/8
墨迹天气,工具,1433,425380815,424634892,745923,1065604.286,2018/4/8
360桌面,系统,1438,261502627,261449830,52797,75424.28571,2018/4/8
鲁大师,系统,147287,97177170,96502776,674394,963420,2018/4/8
三星打印服务插件,系统,1557729,114976872,114877304,99568,142240,2018/4/8
360省电王,系统,1569,197436507,197349961,86546,123637.1429,2018/4/8
搜狐视频,视频,1586,234657518,234410863,246655,352364.2857,2018/4/8
手机京东,育儿母婴,1588,170489110,169455519,1033591,1476558.571,2018/4/8
开心消消乐,游戏,1625930,420838390,420102354,736036,1051480,2018/4/8
酷我音乐,视频,1656,410190403,409505966,684437,977767.1429,2018/4/8
360清理大师,系统,1781604,194523357,193185265,1338092,1911560,2018/4/8
搜狐新闻,阅读,1849,97850501,97707400,143101,204430,2018/4/8
滴滴出行,出行,185732,152856202,152082740,773462,1104945.714,2018/4/8
平安普惠,理财,1937214,134740034,110088153,24651881,35216972.86,2018/4/8
支付宝,理财,1939,689954979,688999398,955581,1365115.714,2018/4/8
腾讯新闻,阅读,19467,320498370,319547597,950773,1358247.143,2018/4/8
360免费WiFi,系统,1954941,251492178,250979850,512328,731897.1429,2018/4/8
美图秀秀,摄影,1977,411431193,410853486,577707,825295.7143,2018/4/8
微博,阅读,2012,695878205,694854720,1023485,1462121.429,2018/4/8
咪咕音乐,视频,201224,92244078,90462342,1781736,2545337.143,2018/4/8
UC浏览器,系统,2058,689912214,688922557,989657,1413795.714,2018/4/8
腾讯视频,视频,2087,447657251,445071932,2585319,3693312.857,2018/4/8
QQ邮箱,办公商务,209310,133059571,132625392,434179,620255.7143,2018/4/8
唯品会,购物,21972,103442542,103079073,363469,519241.4286,2018/4/8
中华万年历日历,工具,2272,146113926,145858836,255090,364414.2857,2018/4/8
美颜相机,摄影,229226,177132571,176713011,419560,599371.4286,2018/4/8
360超级ROOT-深度优化手机,工具,2304476,157772686,157648852,123834,176905.7143,2018/4/8
喜马拉雅FM,视频,236026,90181657,89816285,365372,521960,2018/4/8
驾考宝典,教育学习,2378,115345958,114747809,598149,854498.5714,2018/4/8
随手电筒,工具,246564,96257353,96235246,22107,31581.42857,2018/4/8
单机斗地主-不占流量,游戏,263710,200195877,199958032,237845,339778.5714,2018/4/8
网易新闻,阅读,2744,90375409,,,,2018/4/8
相机360,摄影,2747,104592860,104561358,31502,45002.85714,2018/4/8
爱奇艺,视频,2751,576736983,574656454,2080529,2972184.286,2018/4/8
书旗小说,阅读,2926,133559559,133358616,200943,287061.4286,2018/4/8
网易有道词典,教育学习,2927,192319263,192138064,181199,258855.7143,2018/4/8
携程旅行,出行,2947,135805183,135466140,339043,484347.1429,2018/4/8
花椒直播-美颜椒友疯狂卖萌,社交,2981222,120962025,120688842,273183,390261.4286,2018/4/8
王者荣耀,游戏,3073428,191230485,187114920,4115565,5879378.571,2018/4/8
快手,视频,3536,156932450,154969972,1962478,2803540,2018/4/8
手机淘宝,育儿母婴,3570,892751529,891255856,1495673,2136675.714,2018/4/8
ES文件浏览器,系统,3571,90830247,90802589,27658,39511.42857,2018/4/8
优酷,视频,3581,786118562,784788532,1330030,1900042.857,2018/4/8
蔚蓝小说,阅读,3885739,108547855,93534280,15013575,21447964.29,2018/4/8
小说,阅读,3894208,76161734,66799866,9361868,13374097.14,2018/4/8
免费小说,阅读,3937914,76436936,67821776,8615160,12307371.43,2018/4/8
电子书,阅读,3963018,68057912,56837513,11220399,16029141.43,2018/4/8
有声小说,阅读,3963330,89388573,79217194,10171379,14530541.43,2018/4/8
YY,视频,4067,116887083,116295776,591307,844724.2857,2018/4/8
土豆视频,视频,4107,113752646,113674310,78336,111908.5714,2018/4/8
途牛旅游,出行,43299,145352244,145272296,79948,114211.4286,2018/4/8
酷狗音乐,视频,433,1139059269,1137322737,1736532,2480760,2018/4/8
多米音乐,视频,44,97324322,97298778,25544,36491.42857,2018/4/8
QQ音乐,视频,4498,144112566,143151787,960779,1372541.429,2018/4/8
大众点评,生活服务,4674,172246398,172040159,206239,294627.1429,2018/4/8
陌陌,社交,48,243898755,243560594,338161,483087.1429,2018/4/8
蜻蜓FM,视频,51178,87973973,86198831,1775142,2535917.143,2018/4/8
我查查,工具,537,160885561,160801015,84546,120780,2018/4/8
微信,社交,5427,796639930,790949527,5690403,8129147.143,2018/4/8
58同城,便捷生活,5576,88046257,87725161,321096,458708.5714,2018/4/8
聚力视频,视频,5632,274850293,274706617,143676,205251.4286,2018/4/8
天气通,工具,6209,94146962,94086215,60747,86781.42857,2018/4/8
谷歌拼音,系统,6224,126699140,126616656,82484,117834.2857,2018/4/8
乐视视频,视频,6276,257813962,257661732,152230,217471.4286,2018/4/8
谷歌Gmail,办公商务,6411,93238284,93161162,77122,110174.2857,2018/4/8
驾校一点通,教育学习,6533,73817654,63493291,10324363,14749090,2018/4/8
咪咕阅读,阅读,6536,128897137,127196585,1700552,2429360,2018/4/8
飞信,社交,7372,95018746,95007224,11522,16460,2018/4/8
百度地图,出行,7655,577430846,576566099,864747,1235352.857,2018/4/8
植物大战僵尸2高清版,游戏,771431,217950144,217484252,465892,665560,2018/4/8
360手机卫士-一键连免费wifi,系统,77208,1919536168,1916172016,3364152,4805931.429,2018/4/8
360影视大全,视频,778702,422930434,421837252,1093182,1561688.571,2018/4/8
QQ,社交,7953,795507551,794309267,1198284,1711834.286,2018/4/8
华为手机文件管理器,办公商务,796062,104899050,104413648,485402,693431.4286,2018/4/8
QQ空间,社交,8015,133758554,133653487,105067,150095.7143,2018/4/8
ogle 文字转语音,系统,885077,118811024,118781103,29921,42744.28571,2018/4/8
WiFi万能钥匙,系统,88761,1002918309,999740430,3177879,4539827.143,2018/4/8
HP Print Service 插件,系统,890932,113226854,113145955,80899,115570,2018/4/8
360天气,工具,92235,119204365,119099808,104557,149367.1429,2018/4/8
中国建设银行,理财,9347,108794379,107990818,803561,1147944.286,2018/4/8
去哪儿旅行,出行,944,122866450,122359481,506969,724241.4286,2018/4/8
360浏览器,系统,95487,670195575,667028935,3166640,4523771.429,2018/4/8
360手机助手,工具,100084,273118543,272963236,155307,221867.1429,2018/5/6
人民日报,阅读,101273,86556318,86546561,9757,13938.57143,2018/5/6
风行视频,视频,101594,92642198,92621770,20428,29182.85714,2018/5/6
作业帮,教育学习,1027306,81093170,79865266,1227904,1754148.571,2018/5/6
高德地图,出行,1038,471005721,470100090,905631,1293758.571,2018/5/6
手电筒,工具,1066354,104817936,104805352,12584,17977.14286,2018/5/6
美团,便捷生活,1068,319574612,318554156,1020456,1457794.286,2018/5/6
QQ浏览器,系统,1079,447040881,445126695,1914186,2734551.429,2018/5/6
阿里星球,视频,1088,330131455,330125859,5596,7994.285714,2018/5/6
铃声多多,视频,111237,208719564,208203663,515901,737001.4286,2018/5/6
掌阅iReader,阅读,1152,173691984,173520999,170985,244264.2857,2018/5/6
讯飞输入法,社交,1167,345887358,344996137,891221,1273172.857,2018/5/6
百度视频,视频,12272,165238884,165169471,69413,99161.42857,2018/5/6
Flipboard,阅读,123565,113906529,113774939,131590,187985.7143,2018/5/6
唱吧,视频,125088,110610147,110510778,99369,141955.7143,2018/5/6
今日头条,视频,141843,345939711,343477594,2462117,3517310,2018/5/6
墨迹天气,工具,1433,426366815,425519486,847329,1210470,2018/5/6
360桌面,系统,1438,261590891,261516840,74051,105787.1429,2018/5/6
鲁大师,系统,147287,97998613,97363251,635362,907660,2018/5/6
三星打印服务插件,系统,1557729,115115135,115005203,109932,157045.7143,2018/5/6
360省电王,系统,1569,197509065,197451327,57738,82482.85714,2018/5/6
搜狐视频,视频,1586,235015449,234738799,276650,395214.2857,2018/5/6
手机京东,育儿母婴,1588,172218155,170734686,1483469,2119241.429,2018/5/6
开心消消乐,游戏,1625930,421758306,421069928,688378,983397.1429,2018/5/6
酷我音乐,视频,1656,411472795,410491847,980948,1401354.286,2018/5/6
360清理大师,系统,1781604,197514658,194886426,2628232,3754617.143,2018/5/6
搜狐新闻,阅读,1849,98340002,97920424,419578,599397.1429,2018/5/6
滴滴出行,出行,185732,153777882,152991482,786400,1123428.571,2018/5/6
平安普惠,理财,1937214,174541237,142038438,32502799,46432570,2018/5/6
支付宝,理财,1939,692882202,691120897,1761305,2516150,2018/5/6
腾讯新闻,阅读,19467,321885710,320733824,1151886,1645551.429,2018/5/6
360免费WiFi,系统,1954941,252034520,251639714,394806,564008.5714,2018/5/6
美图秀秀,摄影,1977,412115007,411613663,501344,716205.7143,2018/5/6
微博,阅读,2012,697461900,696101293,1360607,1943724.286,2018/5/6
咪咕音乐,视频,201224,95273992,92902554,2371438,3387768.571,2018/5/6
UC浏览器,系统,2058,691755047,690446724,1308323,1869032.857,2018/5/6
腾讯视频,视频,2087,450919334,448378177,2541157,3630224.286,2018/5/6
QQ邮箱,办公商务,209310,133762341,133305131,457210,653157.1429,2018/5/6
唯品会,购物,21972,103885342,103522895,362447,517781.4286,2018/5/6
中华万年历日历,工具,2272,146456739,146191399,265340,379057.1429,2018/5/6
美颜相机,摄影,229226,177754997,177236679,518318,740454.2857,2018/5/6
360超级ROOT-深度优化手机,工具,2304476,157932641,157806472,126169,180241.4286,2018/5/6
喜马拉雅FM,视频,236026,90581409,90275521,305888,436982.8571,2018/5/6
驾考宝典,教育学习,2378,116068207,115523653,544554,777934.2857,2018/5/6
随手电筒,工具,246564,96274663,96261353,13310,19014.28571,2018/5/6
单机斗地主-不占流量,游戏,263710,200530071,200292228,237843,339775.7143,2018/5/6
网易新闻,阅读,2744,90662658,90417136,245522,350745.7143,2018/5/6
相机360,摄影,2747,104637135,104603211,33924,48462.85714,2018/5/6
爱奇艺,视频,2751,579766284,577348460,2417824,3454034.286,2018/5/6
书旗小说,阅读,2926,133923258,133657272,265986,379980,2018/5/6
网易有道词典,教育学习,2927,192574795,192347502,227293,324704.2857,2018/5/6
携程旅行,出行,2947,136270800,135878021,392779,561112.8571,2018/5/6
花椒直播-美颜椒友疯狂卖萌,社交,2981222,121359236,121044495,314741,449630,2018/5/6
王者荣耀,游戏,3073428,195840238,192300653,3539585,5056550,2018/5/6
快手,视频,3536,159788667,157664462,2124205,3034578.571,2018/5/6
手机淘宝,育儿母婴,3570,896437983,893801483,2636500,3766428.571,2018/5/6
ES文件浏览器,系统,3571,90872360,90837324,35036,50051.42857,2018/5/6
优酷,视频,3581,787981433,786451083,1530350,2186214.286,2018/5/6
蔚蓝小说,阅读,3885739,111202675,109036430,2166245,3094635.714,2018/5/6
小说,阅读,3894208,79092541,76699362,2393179,3418827.143,2018/5/6
免费小说,阅读,3937914,79368140,76975160,2392980,3418542.857,2018/5/6
电子书,阅读,3963018,71474938,68681348,2793590,3990842.857,2018/5/6
有声小说,阅读,3963330,93104107,89959537,3144570,4492242.857,2018/5/6
YY,视频,4067,117772483,117100296,672187,960267.1429,2018/5/6
土豆视频,视频,4107,113845441,113777742,67699,96712.85714,2018/5/6
途牛旅游,出行,43299,145469483,145377492,91991,131415.7143,2018/5/6
酷狗音乐,视频,433,1141652311,1139568366,2083945,2977064.286,2018/5/6
多米音乐,视频,44,97364879,97334170,30709,43870,2018/5/6
QQ音乐,视频,4498,146422194,144669408,1752786,2503980,2018/5/6
大众点评,生活服务,4674,172759376,172311299,448077,640110,2018/5/6
陌陌,社交,48,244356677,243995579,361098,515854.2857,2018/5/6
蜻蜓FM,视频,51178,91661549,88052849,3608700,5155285.714,2018/5/6
我查查,工具,537,160924739,160894853,29886,42694.28571,2018/5/6
微信,社交,5427,802372651,798086502,4286149,6123070,2018/5/6
58同城,便捷生活,5576,88661661,88130479,531182,758831.4286,2018/5/6
聚力视频,视频,5632,275020283,274875324,144959,207084.2857,2018/5/6
百度,系统,5846,411987057,,,,2018/5/6
天气通,工具,6209,94207073,94161785,45288,64697.14286,2018/5/6
谷歌拼音,系统,6224,126800665,126724042,76623,109461.4286,2018/5/6
乐视视频,视频,6276,258015446,257843631,171815,245450,2018/5/6
谷歌Gmail,办公商务,6411,93305256,93253061,52195,74564.28571,2018/5/6
驾校一点通,教育学习,6533,92356234,73825632,18530602,26472288.57,2018/5/6
咪咕阅读,阅读,6536,132663198,128942879,3720319,5314741.429,2018/5/6
飞信,社交,7372,95035283,95022087,13196,18851.42857,2018/5/6
百度地图,出行,7655,578214140,577660685,553455,790650,2018/5/6
植物大战僵尸2高清版,游戏,771431,218741574,218092484,649090,927271.4286,2018/5/6
360手机卫士-一键连免费wifi,系统,77208,1927802103,1922091955,5710148,8157354.286,2018/5/6
360影视大全,视频,778702,424270310,423319273,951037,1358624.286,2018/5/6
QQ,社交,7953,797871488,796095763,1775725,2536750,2018/5/6
华为手机文件管理器,办公商务,796062,105618094,105063281,554813,792590,2018/5/6
QQ空间,社交,8015,133853315,133779366,73949,105641.4286,2018/5/6
ogle 文字转语音,系统,885077,118853029,118819395,33634,48048.57143,2018/5/6
WiFi万能钥匙,系统,88761,1007866592,1004092847,3773745,5391064.286,2018/5/6
HP Print Service 插件,系统,890932,113332186,113248709,83477,119252.8571,2018/5/6
360天气,工具,92235,119296183,119228674,67509,96441.42857,2018/5/6
中国建设银行,理财,9347,109451476,109023335,428141,611630,2018/5/6
去哪儿旅行,出行,944,123689409,122997443,691966,988522.8571,2018/5/6
360浏览器,系统,95487,673957918,671055034,2902884,4146977.143,2018/5/6
360手机助手,工具,100084,273333134,273162856,170278,243254.2857,2018/6/3
人民日报,阅读,101273,89183080,86558909,2624171,3748815.714,2018/6/3
风行视频,视频,101594,92667391,92646373,21018,30025.71429,2018/6/3
作业帮,教育学习,1027306,82696766,81475335,1221431,1744901.429,2018/6/3
高德地图,出行,1038,473861269,472051055,1810214,2586020,2018/6/3
手电筒,工具,1066354,104831820,104820334,11486,16408.57143,2018/6/3
美团,便捷生活,1068,320591866,319788327,803539,1147912.857,2018/6/3
QQ浏览器,系统,1079,449080686,447362859,1717827,2454038.571,2018/6/3
阿里星球,视频,1088,330138000,330132719,5281,7544.285714,2018/6/3
铃声多多,视频,111237,209312857,208858217,454640,649485.7143,2018/6/3
掌阅iReader,阅读,1152,173903011,173719342,183669,262384.2857,2018/6/3
讯飞输入法,社交,1167,346907899,346063175,844724,1206748.571,2018/6/3
百度视频,视频,12272,165342578,165258041,84537,120767.1429,2018/6/3
Flipboard,阅读,123565,114027763,113935829,91934,131334.2857,2018/6/3
唱吧,视频,125088,110706901,110642137,64764,92520,2018/6/3
今日头条,视频,141843,348511121,346624203,1886918,2695597.143,2018/6/3
墨迹天气,工具,1433,427384778,426553989,830789,1186841.429,2018/6/3
360桌面,系统,1438,261665916,261606984,58932,84188.57143,2018/6/3
鲁大师,系统,147287,98700968,98179922,521046,744351.4286,2018/6/3
三星打印服务插件,系统,1557729,115243882,115142290,101592,145131.4286,2018/6/3
360省电王,系统,1569,197633921,197555525,78396,111994.2857,2018/6/3
搜狐视频,视频,1586,235268409,235074433,193976,277108.5714,2018/6/3
手机京东,育儿母婴,1588,174641902,172484104,2157798,3082568.571,2018/6/3
开心消消乐,游戏,1625930,422805666,421950566,855100,1221571.429,2018/6/3
酷我音乐,视频,1656,412676957,411746297,930660,1329514.286,2018/6/3
360清理大师,系统,1781604,199377669,197940379,1437290,2053271.429,2018/6/3
搜狐新闻,阅读,1849,98912169,98483862,428307,611867.1429,2018/6/3
滴滴出行,出行,185732,155061395,154088699,972696,1389565.714,2018/6/3
平安普惠,理财,1937214,221439689,184203555,37236134,53194477.14,2018/6/3
支付宝,理财,1939,695386710,693175659,2211051,3158644.286,2018/6/3
腾讯新闻,阅读,19467,322933309,322125179,808130,1154471.429,2018/6/3
360免费WiFi,系统,1954941,252438723,252124354,314369,449098.5714,2018/6/3
美图秀秀,摄影,1977,413021011,412325117,695894,994134.2857,2018/6/3
微博,阅读,2012,699206422,697872505,1333917,1905595.714,2018/6/3
咪咕音乐,视频,201224,98034631,95774675,2259956,3228508.571,2018/6/3
UC浏览器,系统,2058,693934943,692382846,1552097,2217281.429,2018/6/3
腾讯视频,视频,2087,454111034,451582691,2528343,3611918.571,2018/6/3
QQ邮箱,办公商务,209310,134069052,133877167,191885,274121.4286,2018/6/3
唯品会,购物,21972,104453340,103949509,503831,719758.5714,2018/6/3
中华万年历日历,工具,2272,146810359,146505445,304914,435591.4286,2018/6/3
美颜相机,摄影,229226,178488110,177911491,576619,823741.4286,2018/6/3
360超级ROOT-深度优化手机,工具,2304476,158080288,157962744,117544,167920,2018/6/3
喜马拉雅FM,视频,236026,90867996,90655338,212658,303797.1429,2018/6/3
驾考宝典,教育学习,2378,116280190,116099353,180837,258338.5714,2018/6/3
随手电筒,工具,246564,96295432,96276806,18626,26608.57143,2018/6/3
单机斗地主-不占流量,游戏,263710,200781801,200586619,195182,278831.4286,2018/6/3
网易新闻,阅读,2744,91017110,90708168,308942,441345.7143,2018/6/3
相机360,摄影,2747,104681242,104647273,33969,48527.14286,2018/6/3
爱奇艺,视频,2751,582421187,580390114,2031073,2901532.857,2018/6/3
书旗小说,阅读,2926,134237652,134011397,226255,323221.4286,2018/6/3
网易有道词典,教育学习,2927,192798337,192599218,199119,284455.7143,2018/6/3
携程旅行,出行,2947,136777796,136347404,430392,614845.7143,2018/6/3
花椒直播-美颜椒友疯狂卖萌,社交,2981222,121781783,121456965,324818,464025.7143,2018/6/3
王者荣耀,游戏,3073428,200104276,196816736,3287540,4696485.714,2018/6/3
快手,视频,3536,162814361,160462073,2352288,3360411.429,2018/6/3
手机淘宝,育儿母婴,3570,899060791,897476385,1584406,2263437.143,2018/6/3
ES文件浏览器,系统,3571,90940459,90896808,43651,62358.57143,2018/6/3
优酷,视频,3581,790390959,788467187,1923772,2748245.714,2018/6/3
蔚蓝小说,阅读,3885739,113732619,111774832,1957787,2796838.571,2018/6/3
小说,阅读,3894208,81834359,79717847,2116512,3023588.571,2018/6/3
免费小说,阅读,3937914,82109756,79992900,2116856,3024080,2018/6/3
电子书,阅读,3963018,74661252,72202869,2458383,3511975.714,2018/6/3
有声小说,阅读,3963330,96081783,93846857,2234926,3192751.429,2018/6/3
YY,视频,4067,118342386,117911995,430391,614844.2857,2018/6/3
土豆视频,视频,4107,113938060,113860590,77470,110671.4286,2018/6/3
途牛旅游,出行,43299,145618161,145511211,106950,152785.7143,2018/6/3
酷狗音乐,视频,433,1143955570,1142281958,1673612,2390874.286,2018/6/3
多米音乐,视频,44,97414101,97372459,41642,59488.57143,2018/6/3
QQ音乐,视频,4498,147672696,146752670,920026,1314322.857,2018/6/3
大众点评,生活服务,4674,173076120,172839814,236306,337580,2018/6/3
陌陌,社交,48,244935129,244485420,449709,642441.4286,2018/6/3
蜻蜓FM,视频,51178,91923281,91744696,178585,255121.4286,2018/6/3
我查查,工具,537,161023716,160975584,48132,68760,2018/6/3
微信,社交,5427,813534640,806757260,6777380,9681971.429,2018/6/3
58同城,便捷生活,5576,89360013,88833548,526465,752092.8571,2018/6/3
聚力视频,视频,5632,275222837,275042675,180162,257374.2857,2018/6/3
百度,系统,5846,414619524,412579900,2039624,2913748.571,2018/6/3
天气通,工具,6209,94245804,94214124,31680,45257.14286,2018/6/3
谷歌拼音,系统,6224,126874982,126817068,57914,82734.28571,2018/6/3
乐视视频,视频,6276,258214762,258072849,141913,202732.8571,2018/6/3
谷歌Gmail,办公商务,6411,93355318,93314526,40792,58274.28571,2018/6/3
驾校一点通,教育学习,6533,119813105,97764815,22048290,31497557.14,2018/6/3
咪咕阅读,阅读,6536,136222390,133503420,2718970,3884242.857,2018/6/3
飞信,社交,7372,95052018,95039025,12993,18561.42857,2018/6/3
百度地图,出行,7655,579150585,578339023,811562,1159374.286,2018/6/3
植物大战僵尸2高清版,游戏,771431,219493630,218936878,556752,795360,2018/6/3
360手机卫士-一键连免费wifi,系统,77208,1933947924,1928994681,4953243,7076061.429,2018/6/3
360影视大全,视频,778702,425401773,424575399,826374,1180534.286,2018/6/3
QQ,社交,7953,800296614,798580500,1716114,2451591.429,2018/6/3
华为手机文件管理器,办公商务,796062,106262435,105770581,491854,702648.5714,2018/6/3
QQ空间,社交,8015,133930946,133869495,61451,87787.14286,2018/6/3
ogle 文字转语音,系统,885077,118893234,118861765,31469,44955.71429,2018/6/3
WiFi万能钥匙,系统,88761,1012438190,1008942064,3496126,4994465.714,2018/6/3
HP Print Service 插件,系统,890932,113517579,113352123,165456,236365.7143,2018/6/3
360天气,工具,92235,119351661,119306344,45317,64738.57143,2018/6/3
中国建设银行,理财,9347,110521973,109842799,679174,970248.5714,2018/6/3
去哪儿旅行,出行,944,124212475,123813964,398511,569301.4286,2018/6/3
360浏览器,系统,95487,677477109,674978202,2498907,3569867.143,2018/6/3
360手机助手,工具,100084,273796395,273443948,352447,377621.7857,2018/7/1
人民日报,阅读,101273,93406204,90787072,2619132,2806212.857,2018/7/1
风行视频,视频,101594,92699682,92673794,25888,27737.14286,2018/7/1
作业帮,教育学习,1027306,84089828,83061251,1028577,1102046.786,2018/7/1
高德地图,出行,1038,477326199,474346987,2979212,3192012.857,2018/7/1
手电筒,工具,1066354,104850901,104835719,15182,16266.42857,2018/7/1
美团,便捷生活,1068,321800810,320858049,942761,1010101.071,2018/7/1
QQ浏览器,系统,1079,450859916,449768816,1091100,1169035.714,2018/7/1
阿里星球,视频,1088,330145254,330139368,5886,6306.428571,2018/7/1
铃声多多,视频,111237,209982779,209476936,505843,541974.6429,2018/7/1
掌阅iReader,阅读,1152,174211626,173954230,257396,275781.4286,2018/7/1
讯飞输入法,社交,1167,348144613,347125252,1019361,1092172.5,2018/7/1
百度视频,视频,12272,165458678,165361917,96761,103672.5,2018/7/1
Flipboard,阅读,123565,114139202,114049003,90199,96641.78571,2018/7/1
唱吧,视频,125088,110856403,110748327,108076,115795.7143,2018/7/1
今日头条,视频,141843,351400159,349196627,2203532,2360927.143,2018/7/1
墨迹天气,工具,1433,428653183,427713960,939223,1006310.357,2018/7/1
360桌面,系统,1438,261778512,261700625,77887,83450.35714,2018/7/1
鲁大师,系统,147287,99639513,98875952,763561,818101.0714,2018/7/1
三星打印服务插件,系统,1557729,115393132,115273946,119186,127699.2857,2018/7/1
360省电王,系统,1569,197718672,197651528,67144,71940,2018/7/1
搜狐视频,视频,1586,235671634,235370934,300700,322178.5714,2018/7/1
手机京东,育儿母婴,1588,176475729,175045882,1429847,1531978.929,2018/7/1
开心消消乐,游戏,1625930,424271590,423059846,1211744,1298297.143,2018/7/1
酷我音乐,视频,1656,414108822,413010215,1098607,1177078.929,2018/7/1
360清理大师,系统,1781604,200784790,199696193,1088597,1166353.929,2018/7/1
搜狐新闻,阅读,1849,99329100,99047807,281293,301385.3571,2018/7/1
滴滴出行,出行,185732,156019298,155236484,782814,838729.2857,2018/7/1
平安普惠,理财,1937214,269219973,233028168,36191805,38776933.93,2018/7/1
支付宝,理财,1939,698944925,696664291,2280634,2443536.429,2018/7/1
腾讯新闻,阅读,19467,324185388,323322489,862899,924534.6429,2018/7/1
360免费WiFi,系统,1954941,252858924,252570533,288391,308990.3571,2018/7/1
美图秀秀,摄影,1977,413914153,413249318,664835,712323.2143,2018/7/1
微博,阅读,2012,701952648,699752026,2200622,2357809.286,2018/7/1
咪咕音乐,视频,201224,102555413,98733186,3822227,4095243.214,2018/7/1
UC浏览器,系统,2058,696270864,694619134,1651730,1769710.714,2018/7/1
腾讯视频,视频,2087,458339482,455272853,3066629,3285673.929,2018/7/1
QQ邮箱,办公商务,209310,134566798,134334571,232227,248814.6429,2018/7/1
唯品会,购物,21972,105086772,104599823,486949,521731.0714,2018/7/1
中华万年历日历,工具,2272,147177881,146901903,275978,295690.7143,2018/7/1
美颜相机,摄影,229226,179345657,178656084,689573,738828.2143,2018/7/1
360超级ROOT-深度优化手机,工具,2304476,158254776,158116233,138543,148438.9286,2018/7/1
喜马拉雅FM,视频,236026,91322896,90971484,351412,376512.8571,2018/7/1
驾考宝典,教育学习,2378,117191636,116535046,656590,703489.2857,2018/7/1
随手电筒,工具,246564,96330845,96305619,25226,27027.85714,2018/7/1
单机斗地主-不占流量,游戏,263710,201259016,200893460,365556,391667.1429,2018/7/1
网易新闻,阅读,2744,91414825,91129575,285250,305625,2018/7/1
相机360,摄影,2747,104745220,104693938,51282,54945,2018/7/1
爱奇艺,视频,2751,586639778,583438064,3201714,3430407.857,2018/7/1
书旗小说,阅读,2926,134605379,134325787,279592,299562.8571,2018/7/1
网易有道词典,教育学习,2927,193129327,192840364,288963,309603.2143,2018/7/1
携程旅行,出行,2947,137548857,137051750,497107,532614.6429,2018/7/1
花椒直播-美颜椒友疯狂卖萌,社交,2981222,122353670,121899209,454461,486922.5,2018/7/1
王者荣耀,游戏,3073428,207148710,201798608,5350102,5732252.143,2018/7/1
快手,视频,3536,167004730,163801729,3203001,3431786.786,2018/7/1
手机淘宝,育儿母婴,3570,903500029,900153418,3346611,3585654.643,2018/7/1
ES文件浏览器,系统,3571,91002925,90949857,53068,56858.57143,2018/7/1
优酷,视频,3581,793732164,791042147,2690017,2882161.071,2018/7/1
国金期货,理财,3738906,15715240,151028,15564212,16675941.43,2018/7/1
蔚蓝小说,阅读,3885739,116762095,114434589,2327506,2493756.429,2018/7/1
小说,阅读,3894208,84927294,82577420,2349874,2517722.143,2018/7/1
免费小说,阅读,3937914,85045343,82739544,2305799,2470498.929,2018/7/1
电子书,阅读,3963018,78306419,75519864,2786555,2985594.643,2018/7/1
有声小说,阅读,3963330,98939483,96727182,2212301,2370322.5,2018/7/1
YY,视频,4067,118917801,118476479,441322,472845,2018/7/1
土豆视频,视频,4107,114078342,113962010,116332,124641.4286,2018/7/1
途牛旅游,出行,43299,145788604,145661992,126612,135655.7143,2018/7/1
酷狗音乐,视频,433,1147905901,1144514746,3391155,3633380.357,2018/7/1
多米音乐,视频,44,97496179,97433239,62940,67435.71429,2018/7/1
QQ音乐,视频,4498,149653597,148377247,1276350,1367517.857,2018/7/1
大众点评,生活服务,4674,173415691,173189399,226292,242455.7143,2018/7/1
陌陌,社交,48,245703042,245108205,594837,637325.3571,2018/7/1
蜻蜓FM,视频,51178,92219672,92000754,218918,234555,2018/7/1
我查查,工具,537,161109456,161033146,76310,81760.71429,2018/7/1
微信,社交,5427,820750245,815386955,5363290,5746382.143,2018/7/1
58同城,便捷生活,5576,90399137,89650844,748293,801742.5,2018/7/1
聚力视频,视频,5632,275440943,275263056,177887,190593.2143,2018/7/1
百度,系统,5846,418077375,415287704,2789671,2988933.214,2018/7/1
天气通,工具,6209,94327571,94275285,52286,56020.71429,2018/7/1
谷歌拼音,系统,6224,126952517,126891001,61516,65910,2018/7/1
乐视视频,视频,6276,258440375,258254114,186261,199565.3571,2018/7/1
谷歌Gmail,办公商务,6411,93461625,93368891,92734,99357.85714,2018/7/1
驾校一点通,教育学习,6533,153539926,126339754,27200172,29143041.43,2018/7/1
咪咕阅读,阅读,6536,139407096,136269523,3137573,3361685.357,2018/7/1
飞信,社交,7372,95070216,95055560,14656,15702.85714,2018/7/1
百度地图,出行,7655,580490445,579754797,735648,788194.2857,2018/7/1
植物大战僵尸2高清版,游戏,771431,220934326,219786011,1148315,1230337.5,2018/7/1
360手机卫士-一键连免费wifi,系统,77208,1949751506,1936030487,13721019,14701091.79,2018/7/1
360影视大全,视频,778702,426775713,425743810,1031903,1105610.357,2018/7/1
QQ,社交,7953,803407285,801059683,2347602,2515287.857,2018/7/1
华为手机文件管理器,办公商务,796062,107017760,106433101,584659,626420.3571,2018/7/1
QQ空间,社交,8015,134183401,134011976,171425,183669.6429,2018/7/1
ogle 文字转语音,系统,885077,118942662,118902612,40050,42910.71429,2018/7/1
WiFi万能钥匙,系统,88761,1017959877,1013719701,4240176,4543045.714,2018/7/1
HP Print Service 插件,系统,890932,113658852,113551946,106906,114542.1429,2018/7/1
360天气,工具,92235,119465779,119366722,99057,106132.5,2018/7/1
中国建设银行,理财,9347,111701784,110939943,761841,816258.2143,2018/7/1
去哪儿旅行,出行,944,124622708,124349195,273513,293049.6429,2018/7/1
360浏览器,系统,95487,680843184,678269680,2573504,2757325.714,2018/7/1
360手机助手,工具,100084,274155396,273882549,272847,389781.4286,2018/8/5
人民日报,阅读,101273,93426022,93410779,15243,21775.71429,2018/8/5
风行视频,视频,101594,92722331,92708500,13831,19758.57143,2018/8/5
作业帮,教育学习,1027306,84986219,84326550,659669,942384.2857,2018/8/5
高德地图,出行,1038,479299649,477806588,1493061,2132944.286,2018/8/5
手电筒,工具,1066354,104865429,104854526,10903,15575.71429,2018/8/5
美团,便捷生活,1068,323011659,322184740,826919,1181312.857,2018/8/5
QQ浏览器,系统,1079,452002793,451399900,602893,861275.7143,2018/8/5
阿里星球,视频,1088,330150843,330147011,3832,5474.285714,2018/8/5
铃声多多,视频,111237,210626916,210180323,446593,637990,2018/8/5
掌阅iReader,阅读,1152,174465465,174271630,193835,276907.1429,2018/8/5
讯飞输入法,社交,1167,349147533,348556788,590745,843921.4286,2018/8/5
百度视频,视频,12272,165548471,165489795,58676,83822.85714,2018/8/5
Flipboard,阅读,123565,114226908,114157616,69292,98988.57143,2018/8/5
唱吧,视频,125088,110944208,110881171,63037,90052.85714,2018/8/5
今日头条,视频,141843,353026541,351752952,1273589,1819412.857,2018/8/5
墨迹天气,工具,1433,429359133,428902929,456204,651720,2018/8/5
360桌面,系统,1438,261864294,261808355,55939,79912.85714,2018/8/5
鲁大师,系统,147287,100459740,99871559,588181,840258.5714,2018/8/5
三星打印服务插件,系统,1557729,115508022,115426890,81132,115902.8571,2018/8/5
360省电王,系统,1569,197781942,197739497,42445,60635.71429,2018/8/5
搜狐视频,视频,1586,235882081,235736548,145533,207904.2857,2018/8/5
手机京东,育儿母婴,1588,177903968,176990022,913946,1305637.143,2018/8/5
开心消消乐,游戏,1625930,425195719,424565776,629943,899918.5714,2018/8/5
酷我音乐,视频,1656,415187380,414425041,762339,1089055.714,2018/8/5
360清理大师,系统,1781604,201895920,201124949,770971,1101387.143,2018/8/5
搜狐新闻,阅读,1849,99571874,99408885,162989,232841.4286,2018/8/5
滴滴出行,出行,185732,157002621,156311802,690819,986884.2857,2018/8/5
平安普惠,理财,1937214,314899091,281784733,33114358,47306225.71,2018/8/5
支付宝,理财,1939,700856845,699690888,1165957,1665652.857,2018/8/5
腾讯新闻,阅读,19467,325311128,324576456,734672,1049531.429,2018/8/5
360免费WiFi,系统,1954941,253124148,252927584,196564,280805.7143,2018/8/5
美图秀秀,摄影,1977,414710647,414188172,522475,746392.8571,2018/8/5
微博,阅读,2012,703571064,702444884,1126180,1608828.571,2018/8/5
咪咕音乐,视频,201224,107918494,104820181,3098313,4426161.429,2018/8/5
UC浏览器,系统,2058,697975728,696782361,1193367,1704810,2018/8/5
腾讯视频,视频,2087,461231767,459013881,2217886,3168408.571,2018/8/5
QQ邮箱,办公商务,209310,134980224,134607590,372634,532334.2857,2018/8/5
唯品会,购物,21972,105574597,105225792,348805,498292.8571,2018/8/5
中华万年历日历,工具,2272,147416541,147234189,182352,260502.8571,2018/8/5
美颜相机,摄影,229226,179891631,179492703,398928,569897.1429,2018/8/5
360超级ROOT-深度优化手机,工具,2304476,158389042,158295091,93951,134215.7143,2018/8/5
喜马拉雅FM,视频,236026,91850097,91479005,371092,530131.4286,2018/8/5
驾考宝典,教育学习,2378,120329666,118336102,1993564,2847948.571,2018/8/5
随手电筒,工具,246564,96358942,96338894,20048,28640,2018/8/5
单机斗地主-不占流量,游戏,263710,201590359,201352019,238340,340485.7143,2018/8/5
网易新闻,阅读,2744,91851301,91520049,331252,473217.1429,2018/8/5
相机360,摄影,2747,104790267,104758901,31366,44808.57143,2018/8/5
爱奇艺,视频,2751,590655312,587986166,2669146,3813065.714,2018/8/5
书旗小说,阅读,2926,134889801,134689393,200408,286297.1429,2018/8/5
网易有道词典,教育学习,2927,193324311,193169540,154771,221101.4286,2018/8/5
携程旅行,出行,2947,138113966,137709939,404027,577181.4286,2018/8/5
花椒直播-美颜椒友疯狂卖萌,社交,2981222,122783999,122494106,289893,414132.8571,2018/8/5
王者荣耀,游戏,3073428,212280811,208772673,3508138,5011625.714,2018/8/5
快手,视频,3536,169932978,167800644,2132334,3046191.429,2018/8/5
手机淘宝,育儿母婴,3570,906158195,904191214,1966981,2809972.857,2018/8/5
ES文件浏览器,系统,3571,91109889,91038274,71615,102307.1429,2018/8/5
优酷,视频,3581,795831437,794242586,1588851,2269787.143,2018/8/5
国金期货,理财,3738906,43564404,23400825,20163579,28805112.86,2018/8/5
蔚蓝小说,阅读,3885739,119680987,117575003,2105984,3008548.571,2018/8/5
小说,阅读,3894208,87893666,85749446,2144220,3063171.429,2018/8/5
免费小说,阅读,3937914,87943124,85845812,2097312,2996160,2018/8/5
电子书,阅读,3963018,81781226,79258999,2522227,3603181.429,2018/8/5
有声小说,阅读,3963330,101744002,99717488,2026514,2895020,2018/8/5
YY,视频,4067,119398383,119086538,311845,445492.8571,2018/8/5
土豆视频,视频,4107,114191863,114115062,76801,109715.7143,2018/8/5
途牛旅游,出行,43299,145906791,145819663,87128,124468.5714,2018/8/5
酷狗音乐,视频,433,1150147446,1148644874,1502572,2146531.429,2018/8/5
多米音乐,视频,44,97541576,97511132,30444,43491.42857,2018/8/5
QQ音乐,视频,4498,151212169,150357447,854722,1221031.429,2018/8/5
大众点评,生活服务,4674,173916937,173568608,348329,497612.8571,2018/8/5
陌陌,社交,48,246228045,245867648,360397,514852.8571,2018/8/5
蜻蜓FM,视频,51178,92427987,92292997,134990,192842.8571,2018/8/5
我查查,工具,537,161147776,161122314,25462,36374.28571,2018/8/5
微信,社交,5427,827799117,822077517,5721600,8173714.286,2018/8/5
58同城,便捷生活,5576,91095904,90648972,446932,638474.2857,2018/8/5
聚力视频,视频,5632,275746878,275538386,208492,297845.7143,2018/8/5
百度,系统,5846,420527341,418726286,1801055,2572935.714,2018/8/5
天气通,工具,6209,94365932,94337245,28687,40981.42857,2018/8/5
谷歌拼音,系统,6224,127008772,126969038,39734,56762.85714,2018/8/5
乐视视频,视频,6276,258615758,258483341,132417,189167.1429,2018/8/5
谷歌Gmail,办公商务,6411,93548642,93482797,65845,94064.28571,2018/8/5
驾校一点通,教育学习,6533,153590119,153552011,38108,54440,2018/8/5
咪咕阅读,阅读,6536,141872370,139894185,1978185,2825978.571,2018/8/5
飞信,社交,7372,95085024,95074527,10497,14995.71429,2018/8/5
百度地图,出行,7655,582038406,580656721,1381685,1973835.714,2018/8/5
植物大战僵尸2高清版,游戏,771431,222081216,221229833,851383,1216261.429,2018/8/5
360手机卫士-一键连免费wifi,系统,77208,1979188979,1957052295,22136684,31623834.29,2018/8/5
360影视大全,视频,778702,427863918,427071234,792684,1132405.714,2018/8/5
QQ,社交,7953,805666346,804021144,1645202,2350288.571,2018/8/5
华为手机文件管理器,办公商务,796062,107568701,107175183,393518,562168.5714,2018/8/5
QQ空间,社交,8015,134345495,134223063,122432,174902.8571,2018/8/5
ogle 文字转语音,系统,885077,118979132,118952222,26910,38442.85714,2018/8/5
WiFi万能钥匙,系统,88761,1022052407,1019099125,2953282,4218974.286,2018/8/5
HP Print Service 插件,系统,890932,113761164,113685871,75293,107561.4286,2018/8/5
360天气,工具,92235,119556655,119483666,72989,104270,2018/8/5
中国建设银行,理财,9347,112302886,112009464,293422,419174.2857,2018/8/5
去哪儿旅行,出行,944,124985512,124780709,204803,292575.7143,2018/8/5
360浏览器,系统,95487,684352247,682143813,2208434,3154905.714,2018/8/5
360手机助手,工具,100084,274419851,274224987,194864,208782.8571,2018/9/2
人民日报,阅读,101273,93449690,93430645,19045,20405.35714,2018/9/2
风行视频,视频,101594,92761945,92731892,30053,32199.64286,2018/9/2
作业帮,教育学习,1027306,86941033,85403260,1537773,1647613.929,2018/9/2
高德地图,出行,1038,482145528,479890550,2254978,2416047.857,2018/9/2
手电筒,工具,1066354,104880952,104868751,12201,13072.5,2018/9/2
美团,便捷生活,1068,324134742,323214937,919805,985505.3571,2018/9/2
QQ浏览器,系统,1079,453867312,452528918,1338394,1433993.571,2018/9/2
阿里星球,视频,1088,330158941,330152498,6443,6903.214286,2018/9/2
铃声多多,视频,111237,211264164,210778728,485436,520110,2018/9/2
掌阅iReader,阅读,1152,174721390,174514468,206922,221702.1429,2018/9/2
讯飞输入法,社交,1167,350522192,349610989,911203,976288.9286,2018/9/2
百度视频,视频,12272,165644980,165576198,68782,73695,2018/9/2
Flipboard,阅读,123565,114339419,114247385,92034,98607.85714,2018/9/2
唱吧,视频,125088,111055431,110962324,93107,99757.5,2018/9/2
今日头条,视频,141843,355686818,353579976,2106842,2257330.714,2018/9/2
墨迹天气,工具,1433,430123655,429561841,561814,601943.5714,2018/9/2
360桌面,系统,1438,261950658,261879668,70990,76060.71429,2018/9/2
鲁大师,系统,147287,101455815,100687115,768700,823607.1429,2018/9/2
三星打印服务插件,系统,1557729,115630330,115539361,90969,97466.78571,2018/9/2
360省电王,系统,1569,197852315,197800423,51892,55598.57143,2018/9/2
搜狐视频,视频,1586,236171261,235952419,218842,234473.5714,2018/9/2
手机京东,育儿母婴,1588,179782315,178431608,1350707,1447186.071,2018/9/2
开心消消乐,游戏,1625930,426337480,425540639,796841,853758.2143,2018/9/2
酷我音乐,视频,1656,416427535,415433308,994227,1065243.214,2018/9/2
360清理大师,系统,1781604,203268348,202181239,1087109,1164759.643,2018/9/2
搜狐新闻,阅读,1849,99900406,99626398,274008,293580,2018/9/2
滴滴出行,出行,185732,157931232,157101560,829672,888934.2857,2018/9/2
平安普惠,理财,1937214,371745273,327008835,44736438,47931897.86,2018/9/2
支付宝,理财,1939,704529877,701356635,3173242,3399902.143,2018/9/2
腾讯新闻,阅读,19467,326848328,325629010,1219318,1306412.143,2018/9/2
360免费WiFi,系统,1954941,253446995,253192496,254499,272677.5,2018/9/2
美图秀秀,摄影,1977,415647182,414911679,735503,788038.9286,2018/9/2
微博,阅读,2012,705354328,703972628,1381700,1480392.857,2018/9/2
咪咕音乐,视频,201224,112627863,108597215,4030648,4318551.429,2018/9/2
UC浏览器,系统,2058,699838116,698326654,1511462,1619423.571,2018/9/2
腾讯视频,视频,2087,463975167,462076404,1898763,2034388.929,2018/9/2
QQ邮箱,办公商务,209310,135597520,135031714,565806,606220.7143,2018/9/2
唯品会,购物,21972,106109297,105703576,405721,434701.0714,2018/9/2
中华万年历日历,工具,2272,147660692,147484484,176208,188794.2857,2018/9/2
美颜相机,摄影,229226,180467218,180037962,429256,459917.1429,2018/9/2
360超级ROOT-深度优化手机,工具,2304476,158523929,158424084,99845,106976.7857,2018/9/2
喜马拉雅FM,视频,236026,92500099,92021367,478732,512927.1429,2018/9/2
驾考宝典,教育学习,2378,124430278,121698556,2731722,2926845,2018/9/2
百度贴吧,社交,2461,98243200,97991266,251934,269929.2857,2018/9/2
随手电筒,工具,246564,96384594,96366372,18222,19523.57143,2018/9/2
单机斗地主-不占流量,游戏,263710,202002249,201696117,306132,327998.5714,2018/9/2
网易新闻,阅读,2744,92480009,91982213,497796,533352.8571,2018/9/2
相机360,摄影,2747,104845216,104803140,42076,45081.42857,2018/9/2
爱奇艺,视频,2751,594003612,591423001,2580611,2764940.357,2018/9/2
书旗小说,阅读,2926,135240838,134957720,283118,303340.7143,2018/9/2
网易有道词典,教育学习,2927,193588835,193368703,220132,235855.7143,2018/9/2
携程旅行,出行,2947,138706174,138194747,511427,547957.5,2018/9/2
花椒直播-美颜椒友疯狂卖萌,社交,2981222,123162035,122869786,292249,313123.9286,2018/9/2
快手,视频,3536,172753786,170782361,1971425,2112241.071,2018/9/2
手机淘宝,育儿母婴,3570,909902471,906687507,3214964,3444604.286,2018/9/2
ES文件浏览器,系统,3571,91203820,91146743,57077,61153.92857,2018/9/2
优酷,视频,3581,798317744,796263199,2054545,2201298.214,2018/9/2
国金期货,理财,3738906,75514873,48444055,27070818,29004447.86,2018/9/2
蔚蓝小说,阅读,3885739,123310578,120451401,2859177,3063403.929,2018/9/2
小说,阅读,3894208,91586299,88677104,2909195,3116994.643,2018/9/2
免费小说,阅读,3937914,91557835,88710074,2847761,3051172.5,2018/9/2
电子书,阅读,3963018,86104744,82703511,3401233,3644178.214,2018/9/2
有声小说,阅读,3963330,105244295,102484881,2759414,2956515,2018/9/2
YY,视频,4067,119954462,119524448,430014,460729.2857,2018/9/2
土豆视频,视频,4107,114287992,114220239,67753,72592.5,2018/9/2
途牛旅游,出行,43299,146069850,145942709,127141,136222.5,2018/9/2
酷狗音乐,视频,433,1152605854,1150626936,1978918,2120269.286,2018/9/2
多米音乐,视频,44,97581988,97552093,29895,32030.35714,2018/9/2
QQ音乐,视频,4498,152535962,151456566,1079396,1156495.714,2018/9/2
大众点评,生活服务,4674,174385169,174059144,326025,349312.5,2018/9/2
陌陌,社交,48,246828688,246360433,468255,501701.7857,2018/9/2
蜻蜓FM,视频,51178,92731857,92503752,228105,244398.2143,2018/9/2
我查查,工具,537,161229090,161154941,74149,79445.35714,2018/9/2
微信,社交,5427,835107344,829601634,5505710,5898975,2018/9/2
58同城,便捷生活,5576,91880389,91235657,644732,690784.2857,2018/9/2
聚力视频,视频,5632,276097541,275818114,279427,299386.0714,2018/9/2
百度,系统,5846,423666273,421458573,2207700,2365392.857,2018/9/2
天气通,工具,6209,94447106,94380382,66724,71490,2018/9/2
谷歌拼音,系统,6224,127065963,127023274,42689,45738.21429,2018/9/2
乐视视频,视频,6276,258784721,258657478,127243,136331.7857,2018/9/2
谷歌Gmail,办公商务,6411,93648537,93564105,84432,90462.85714,2018/9/2
驾校一点通,教育学习,6533,153652451,153599914,52537,56289.64286,2018/9/2
咪咕阅读,阅读,6536,145612751,142392456,3220295,3450316.071,2018/9/2
飞信,社交,7372,95101727,95089275,12452,13341.42857,2018/9/2
百度地图,出行,7655,583172593,582273757,898836,963038.5714,2018/9/2
植物大战僵尸2高清版,游戏,771431,223048915,222368213,680702,729323.5714,2018/9/2
360手机卫士-一键连免费wifi,系统,77208,2020727575,1987949478,32778097,35119389.64,2018/9/2
360影视大全,视频,778702,428921382,428100109,821273,879935.3571,2018/9/2
QQ,社交,7953,808029540,806379894,1649646,1767477.857,2018/9/2
华为手机文件管理器,办公商务,796062,108165356,107706048,459308,492115.7143,2018/9/2
QQ空间,社交,8015,134536068,134414391,121677,130368.2143,2018/9/2
ogle 文字转语音,系统,885077,119018257,118989097,29160,31242.85714,2018/9/2
WiFi万能钥匙,系统,88761,1026895889,1023154717,3741172,4008398.571,2018/9/2
HP Print Service 插件,系统,890932,113840173,113783805,56368,60394.28571,2018/9/2
360天气,工具,92235,119636963,119582902,54061,57922.5,2018/9/2
中国建设银行,理财,9347,113261342,112593746,667596,715281.4286,2018/9/2
去哪儿旅行,出行,944,125529760,125127972,401788,430487.1429,2018/9/2
360浏览器,系统,95487,686971416,684940396,2031020,2176092.857,2018/9/2
360手机助手,工具,100084,274549570,274517762,31808,136320,2018/10/14
人民日报,阅读,101273,93458362,93455887,2475,10607.14286,2018/10/14
风行视频,视频,101594,92773659,92769702,3957,16958.57143,2018/10/14
作业帮,教育学习,1027306,87943260,87710078,233182,999351.4286,2018/10/14
高德地图,出行,1038,482908740,482734584,174156,746382.8571,2018/10/14
手电筒,工具,1066354,104892493,104887074,5419,23224.28571,2018/10/14
美团,便捷生活,1068,324625065,324392915,232150,994928.5714,2018/10/14
QQ浏览器,系统,1079,454392242,454272053,120189,515095.7143,2018/10/14
阿里星球,视频,1088,330162644,330161581,1063,4555.714286,2018/10/14
铃声多多,视频,111237,211606890,211462048,144842,620751.4286,2018/10/14
掌阅iReader,阅读,1152,174824938,174793586,31352,134365.7143,2018/10/14
讯飞输入法,社交,1167,350938871,350837345,101526,435111.4286,2018/10/14
百度视频,视频,12272,165697076,165668774,28302,121294.2857,2018/10/14
Flipboard,阅读,123565,114383056,114364176,18880,80914.28571,2018/10/14
唱吧,视频,125088,111103270,111082153,21117,90501.42857,2018/10/14
今日头条,视频,141843,357093805,356675766,418039,1791595.714,2018/10/14
墨迹天气,工具,1433,430408101,430277916,130185,557935.7143,2018/10/14
360桌面,系统,1438,261997651,261985408,12243,52470,2018/10/14
鲁大师,系统,147287,101895472,101773274,122198,523705.7143,2018/10/14
三星打印服务插件,系统,1557729,115694131,115674297,19834,85002.85714,2018/10/14
360省电王,系统,1569,197886969,197876363,10606,45454.28571,2018/10/14
搜狐视频,视频,1586,236377759,236302789,74970,321300,2018/10/14
手机京东,育儿母婴,1588,180569050,180171360,397690,1704385.714,2018/10/14
开心消消乐,游戏,1625930,426904216,426755734,148482,636351.4286,2018/10/14
酷我音乐,视频,1656,416989838,416799694,190144,814902.8571,2018/10/14
360清理大师,系统,1781604,204522271,204151736,370535,1588007.143,2018/10/14
滴滴出行,出行,185732,158283842,158112530,171312,734194.2857,2018/10/14
平安普惠,理财,1937214,403208278,392770422,10437856,44733668.57,2018/10/14
支付宝,理财,1939,705960187,705283833,676354,2898660,2018/10/14
腾讯新闻,阅读,19467,327591337,327385724,205613,881198.5714,2018/10/14
360免费WiFi,系统,1954941,253601165,253553989,47176,202182.8571,2018/10/14
美图秀秀,摄影,1977,415970306,415845687,124619,534081.4286,2018/10/14
微博,阅读,2012,705924876,705710607,214269,918295.7143,2018/10/14
咪咕音乐,视频,201224,115395830,114524484,871346,3734340,2018/10/14
UC浏览器,系统,2058,701021994,700604327,417667,1790001.429,2018/10/14
腾讯视频,视频,2087,465559032,465019566,539466,2311997.143,2018/10/14
QQ邮箱,办公商务,209310,135731747,135693206,38541,165175.7143,2018/10/14
唯品会,购物,21972,106377414,106284718,92696,397268.5714,2018/10/14
中华万年历日历,工具,2272,147745403,147720348,25055,107378.5714,2018/10/14
美颜相机,摄影,229226,180766162,180664244,101918,436791.4286,2018/10/14
360超级ROOT-深度优化手机,工具,2304476,158597745,158575410,22335,95721.42857,2018/10/14
喜马拉雅FM,视频,236026,92838844,92752944,85900,368142.8571,2018/10/14
驾考宝典,教育学习,2378,125949885,124859426,1090459,4673395.714,2018/10/14
百度贴吧,社交,2461,98383455,98321794,61661,264261.4286,2018/10/14
随手电筒,工具,246564,96403521,96395110,8411,36047.14286,2018/10/14
单机斗地主-不占流量,游戏,263710,202194039,202151887,42152,180651.4286,2018/10/14
网易新闻,阅读,2744,92715735,92632449,83286,356940,2018/10/14
相机360,摄影,2747,104865706,104857482,8224,35245.71429,2018/10/14
爱奇艺,视频,2751,595700019,595025637,674382,2890208.571,2018/10/14
书旗小说,阅读,2926,135454580,135394228,60352,258651.4286,2018/10/14
网易有道词典,教育学习,2927,193689120,193657433,31687,135801.4286,2018/10/14
携程旅行,出行,2947,138904736,138858881,45855,196521.4286,2018/10/14
花椒直播-美颜椒友疯狂卖萌,社交,2981222,123380577,123301596,78981,338490,2018/10/14
快手,视频,3536,174928883,174202304,726579,3113910,2018/10/14
手机淘宝,育儿母婴,3570,911970907,911135243,835664,3581417.143,2018/10/14
ES文件浏览器,系统,3571,91229696,91222188,7508,32177.14286,2018/10/14
优酷,视频,3581,799600415,799224628,375787,1610515.714,2018/10/14
国金期货,理财,3738906,79974826,76684264,3290562,14102408.57,2018/10/14
蔚蓝小说,阅读,3885739,125249914,124605478,644436,2761868.571,2018/10/14
小说,阅读,3894208,93588268,92933943,654325,2804250,2018/10/14
免费小说,阅读,3937914,93487584,92846436,641148,2747777.143,2018/10/14
电子书,阅读,3963018,88309000,87618027,690973,2961312.857,2018/10/14
有声小说,阅读,3963330,107151120,106467370,683750,2930357.143,2018/10/14
YY,视频,4067,120056839,120020407,36432,156137.1429,2018/10/14
土豆视频,视频,4107,114335784,114313058,22726,97397.14286,2018/10/14
途牛旅游,出行,43299,146161440,146132035,29405,126021.4286,2018/10/14
酷狗音乐,视频,433,1153797542,1153482643,314899,1349567.143,2018/10/14
多米音乐,视频,44,97601816,97595743,6073,26027.14286,2018/10/14
QQ音乐,视频,4498,153354209,152955988,398221,1706661.429,2018/10/14
大众点评,生活服务,4674,174540051,174492182,47869,205152.8571,2018/10/14
陌陌,社交,48,247122981,247022968,100013,428627.1429,2018/10/14
蜻蜓FM,视频,51178,92848327,92813723,34604,148302.8571,2018/10/14
我查查,工具,537,161250932,161244934,5998,25705.71429,2018/10/14
微信,社交,5427,839547139,838609915,937224,4016674.286,2018/10/14
58同城,便捷生活,5576,92676400,92409563,266837,1143587.143,2018/10/14
聚力视频,视频,5632,276267040,276212626,54414,233202.8571,2018/10/14
百度,系统,5846,425155977,424813741,342236,1466725.714,2018/10/14
天气通,工具,6209,94471669,94464181,7488,32091.42857,2018/10/14
谷歌拼音,系统,6224,127095170,127086371,8799,37710,2018/10/14
乐视视频,视频,6276,258865272,258838989,26283,112641.4286,2018/10/14
谷歌Gmail,办公商务,6411,93711996,93688894,23102,99008.57143,2018/10/14
驾校一点通,教育学习,6533,153682789,153671727,11062,47408.57143,2018/10/14
咪咕阅读,阅读,6536,147527116,146586869,940247,4029630,2018/10/14
飞信,社交,7372,95111076,95108417,2659,11395.71429,2018/10/14
百度地图,出行,7655,583524478,583441371,83107,356172.8571,2018/10/14
植物大战僵尸2高清版,游戏,771431,223629989,223459001,170988,732805.7143,2018/10/14
360手机卫士-一键连免费wifi,系统,77208,2053657500,2043126606,10530894,45132402.86,2018/10/14
360影视大全,视频,778702,429692135,429462881,229254,982517.1429,2018/10/14
QQ,社交,7953,808918976,808699194,219782,941922.8571,2018/10/14
华为手机文件管理器,办公商务,796062,108466471,108377480,88991,381390,2018/10/14
QQ空间,社交,8015,134599049,134583948,15101,64718.57143,2018/10/14
ogle 文字转语音,系统,885077,119039629,119033150,6479,27767.14286,2018/10/14
WiFi万能钥匙,系统,88761,1029402469,1028396607,1005862,4310837.143,2018/10/14
HP Print Service 插件,系统,890932,113880370,113870505,9865,42278.57143,2018/10/14
360天气,工具,92235,119663691,119655139,8552,36651.42857,2018/10/14
中国建设银行,理财,9347,113634580,113567946,66634,285574.2857,2018/10/14
去哪儿旅行,出行,944,125726244,125664848,61396,263125.7143,2018/10/14
360浏览器,系统,95487,689046389,688414409,631980,2708485.714,2018/10/14
360手机助手,工具,100084,274633997,274623324,10673,45741.42857,2018/11/4
人民日报,阅读,101273,93469946,93469142,804,3445.714286,2018/11/4
风行视频,视频,101594,92786026,92785041,985,4221.428571,2018/11/4
作业帮,教育学习,1027306,88802052,88690786,111266,476854.2857,2018/11/4
高德地图,出行,1038,484050500,483977142,73358,314391.4286,2018/11/4
手电筒,工具,1066354,104903179,104902054,1125,4821.428571,2018/11/4
美团,便捷生活,1068,325254034,325204883,49151,210647.1429,2018/11/4
QQ浏览器,系统,1079,455157282,455087344,69938,299734.2857,2018/11/4
阿里星球,视频,1088,330165136,330164846,290,1242.857143,2018/11/4
铃声多多,视频,111237,211952380,211902444,49936,214011.4286,2018/11/4
掌阅iReader,阅读,1152,174946065,174933316,12749,54638.57143,2018/11/4
讯飞输入法,社交,1167,351456400,351407502,48898,209562.8571,2018/11/4
百度视频,视频,12272,165753488,165747300,6188,26520,2018/11/4
Flipboard,阅读,123565,114422615,114417128,5487,23515.71429,2018/11/4
唱吧,视频,125088,111144321,111139854,4467,19144.28571,2018/11/4
今日头条,视频,141843,358248737,358126059,122678,525762.8571,2018/11/4
墨迹天气,工具,1433,430708979,430678925,30054,128802.8571,2018/11/4
360桌面,系统,1438,262027471,262023180,4291,18390,2018/11/4
鲁大师,系统,147287,102364885,102322214,42671,182875.7143,2018/11/4
三星打印服务插件,系统,1557729,115742756,115737385,5371,23018.57143,2018/11/4
360省电王,系统,1569,197915447,197911080,4367,18715.71429,2018/11/4
搜狐视频,视频,1586,236566945,236544303,22642,97037.14286,2018/11/4
手机京东,育儿母婴,1588,181597526,181497209,100317,429930,2018/11/4
开心消消乐,游戏,1625930,427417946,,,,2018/11/4
酷我音乐,视频,1656,417580519,417530132,50387,215944.2857,2018/11/4
360清理大师,系统,1781604,205579089,205510120,68969,295581.4286,2018/11/4
搜狐新闻,阅读,1849,100130904,100114427,16477,70615.71429,2018/11/4
滴滴出行,出行,185732,158613371,158594701,18670,80014.28571,2018/11/4
平安普惠,理财,1937214,429963796,427899740,2064056,8845954.286,2018/11/4
支付宝,理财,1939,706887895,706799333,88562,379551.4286,2018/11/4
腾讯新闻,阅读,19467,328397990,328307419,90571,388161.4286,2018/11/4
360免费WiFi,系统,1954941,253704626,253692996,11630,49842.85714,2018/11/4
美图秀秀,摄影,1977,416359300,416309477,49823,213527.1429,2018/11/4
微博,阅读,2012,706535582,706481680,53902,231008.5714,2018/11/4
咪咕音乐,视频,201224,119192282,118880165,312117,1337644.286,2018/11/4
UC浏览器,系统,2058,701974293,701895065,79228,339548.5714,2018/11/4
腾讯视频,视频,2087,466729545,466590713,138832,594994.2857,2018/11/4
QQ邮箱,办公商务,209310,136014161,136001217,12944,55474.28571,2018/11/4
唯品会,购物,21972,106662052,106608796,53256,228240,2018/11/4
中华万年历日历,工具,2272,147813658,147805267,8391,35961.42857,2018/11/4
美颜相机,摄影,229226,181057880,181033309,24571,105304.2857,2018/11/4
360超级ROOT-深度优化手机,工具,2304476,158652516,158646531,5985,25650,2018/11/4
喜马拉雅FM,视频,236026,93142902,93116625,26277,112615.7143,2018/11/4
驾考宝典,教育学习,2378,128373662,127495739,877923,3762527.143,2018/11/4
百度贴吧,社交,2461,98491429,98484953,6476,27754.28571,2018/11/4
随手电筒,工具,246564,96411074,96410388,686,2940,2018/11/4
单机斗地主-不占流量,游戏,263710,202349213,,,,2018/11/4
网易新闻,阅读,2744,92931255,92910678,20577,88187.14286,2018/11/4
相机360,摄影,2747,104886747,104882414,4333,18570,2018/11/4
爱奇艺,视频,2751,597049368,596881558,167810,719185.7143,2018/11/4
书旗小说,阅读,2926,135688369,135667928,20441,87604.28571,2018/11/4
网易有道词典,教育学习,2927,193747265,193742306,4959,21252.85714,2018/11/4
携程旅行,出行,2947,139114422,139097257,17165,73564.28571,2018/11/4
花椒直播-美颜椒友疯狂卖萌,社交,2981222,123537871,123523053,14818,63505.71429,2018/11/4
王者荣耀,游戏,3073428,219840566,219654143,186423,798955.7143,2018/11/4
快手,视频,3536,177070161,176785245,284916,1221068.571,2018/11/4
手机淘宝,育儿母婴,3570,913852159,913525657,326502,1399294.286,2018/11/4
ES文件浏览器,系统,3571,91248153,91246145,2008,8605.714286,2018/11/4
优酷,视频,3581,800734823,800621972,112851,483647.1429,2018/11/4
国金期货,理财,3738906,88886185,88168426,717759,3076110,2018/11/4
蔚蓝小说,阅读,3885739,126913287,126779782,133505,572164.2857,2018/11/4
小说,阅读,3894208,95294246,95163398,130848,560777.1429,2018/11/4
免费小说,阅读,3937914,95173567,95045136,128431,550418.5714,2018/11/4
电子书,阅读,3963018,90137812,90004194,133618,572648.5714,2018/11/4
有声小说,阅读,3963330,108804973,108671305,133668,572862.8571,2018/11/4
YY,视频,4067,120101665,120097370,4295,18407.14286,2018/11/4
土豆视频,视频,4107,114375832,114370834,4998,21420,2018/11/4
途牛旅游,出行,43299,146254695,146246213,8482,36351.42857,2018/11/4
酷狗音乐,视频,433,1155132143,1154986052,146091,626104.2857,2018/11/4
多米音乐,视频,44,97618585,97616419,2166,9282.857143,2018/11/4
QQ音乐,视频,4498,154220726,154120726,100000,428571.4286,2018/11/4
大众点评,生活服务,4674,174750041,174704422,45619,195510,2018/11/4
陌陌,社交,48,247415401,247391542,23859,102252.8571,2018/11/4
蜻蜓FM,视频,51178,92994182,92979639,14543,62327.14286,2018/11/4
我查查,工具,537,161301260,161298272,2988,12805.71429,2018/11/4
微信,社交,5427,841998629,841715992,282637,1211301.429,2018/11/4
58同城,便捷生活,5576,93416909,93347909,69000,295714.2857,2018/11/4
聚力视频,视频,5632,276434437,276414420,20017,85787.14286,2018/11/4
百度,系统,5846,426707877,426554307,153570,658157.1429,2018/11/4
天气通,工具,6209,94505402,94502613,2789,11952.85714,2018/11/4
谷歌拼音,系统,6224,127116967,127114286,2681,11490,2018/11/4
乐视视频,视频,6276,258935234,258928546,6688,28662.85714,2018/11/4
谷歌Gmail,办公商务,6411,93742698,93739564,3134,13431.42857,2018/11/4
驾校一点通,教育学习,6533,153706967,153704325,2642,11322.85714,2018/11/4
咪咕阅读,阅读,6536,149551889,149302588,249301,1068432.857,2018/11/4
飞信,社交,7372,95117928,95117081,847,3630,2018/11/4
百度地图,出行,7655,584057387,583990274,67113,287627.1429,2018/11/4
植物大战僵尸2高清版,游戏,771431,224027941,,,,2018/11/4
360手机卫士-一键连免费wifi,系统,77208,2067256828,2065314794,1942034,8323002.857,2018/11/4
360影视大全,视频,778702,430432858,430356753,76105,326164.2857,2018/11/4
QQ,社交,7953,809961126,809865685,95441,409032.8571,2018/11/4
华为手机文件管理器,办公商务,796062,108719852,108696629,23223,99527.14286,2018/11/4
QQ空间,社交,8015,134632073,134628360,3713,15912.85714,2018/11/4
ogle 文字转语音,系统,885077,119055916,119054126,1790,7671.428571,2018/11/4
WiFi万能钥匙,系统,88761,1031650101,1031410917,239184,1025074.286,2018/11/4
HP Print Service 插件,系统,890932,113901689,113899457,2232,9565.714286,2018/11/4
360天气,工具,92235,119684605,119682362,2243,9612.857143,2018/11/4
中国建设银行,理财,9347,114160588,114128170,32418,138934.2857,2018/11/4
去哪儿旅行,出行,944,126032492,126002088,30404,130302.8571,2018/11/4
360浏览器,系统,95487,690749140,690437604,311536,1335154.286,2018/11/4
